4 3 2 5 4 3 2 4 5 2 5 2 2 3 5 3
3 2 5 4 3 2 4 5 2 5 2 1 3 5 3 4
2 5 1 3 2 1 5 1 5 2 2 3 5 3 4 3
5 4 3 2 4 5 2 5 2 1 3 5 1 4 3 2
4 3 2 4 5 2 5 1 2 3 5 3 4 3 2 1
3 2 4 5 2 5 2 2 3 5 3 4 3 2 5 4
